mmmmmmmmmmmm
m          m
m g g mmmm m
m g g    m m
  g g mm m m
  g g  m m m
    g      m
    ggg g  m
  m     g  m
  mm  ggg  m
           m
       mmmmm
