cc        cc
ccc      ccc
c cc    ccvc
c  cc  cc vc
cS  c     vc
c   c  c  vc
c   c  c  vc
c      c  vc
c  cc  cc vc
c cc    ccvc
ccc      ccc
cc        cc
