c           
c           
c l      mm 
c l       m 
c l       m 
c l  S    m 
c l       m 
c l       m 
c l       m 
c l      mm 
c           
c           
