           c
           c
 mm      m c
 m       m c
 m       m c
 m       m c
 m S     m c
 m       m c
 m       m c
 mm      m c
           c
           c
