m          m
m          m
m    g     m
m    g     m
m   gwg    m
m    g     m
m   gwg    m
m  gwgwg   m
m   gwg    m
m    w   g m
m    w  gwgm
mmmmmmmmmmmm
