mmmmm       
m           
m  ggg  mm  
m  g     m  
m  g ggg    
m      g    
m m m  g g  
m m mm g g  
m m    g g m
m mmmm g g m
m          m
mmmmmmmmmmmm
