mmmmmmmmmmmm
m     w    m
m     w    m
m    gwg   m
m   gwgwg  m
m    gwg   m
m     g    m
m    gwg   m
m     g    m
m     g    m
m g        m
mgwg       m
