cccccccccccc
c     w    c
c     w    c
c          c
c          c
c          c
c     S    c
c          c
c          c
c          c
c g        c
cgwg       c
