cc        cc
cgc      cgc
c gc    cg c
c  gc  cg  c
c   c      c
c   c  c   c
c   c  c   c
c      c   c
c  gc  cg  c
c gc    cg c
cgc      cgc
cc        cc
