mm        mm
mgm      mgm
m gm    mg m
m  gm  mg  m
m   m      m
m   m  m   m
m   m  m   m
m      m   m
m  gm  mg  m
m gm    mg m
mgm      mgm
mm        mm
